{
    "enemies": [
        { "x": 50, "y": 20 },
        { "x": 100, "y": 20 },
        { "x": 150, "y": 20 },
        { "x": 200, "y": 20 },
        { "x": 250, "y": 20 },
        { "x": 300, "y": 20 },
        { "x": 350, "y": 20 },
        { "x": 400, "y": 20 }
    ]
}
